
Type	Name	Latest commit message	Commit time
..		
adicionar_anotacao_tarefa.feature	commit final	8 months ago
adicionar_editar_categoria.feature	commit final	8 months ago
adicionar_usuario_projeto.feature	commit final	8 months ago
alterar_status_tarefa.feature	commit final	8 months ago
aplicar_marcador_tarefa.feature	commit final	8 months ago
cadastrar_campo_personalizado.feature	commit final	8 months ago
cadastrar_categoria.feature	commit final	8 months ago
cadastrar_marcador.feature	enviar lembrete, gerenciar campo personalizado e gerenciar marcador	9 months ago
cadastrar_perfil.feature	revisão	8 months ago
cadastrar_projeto.feature	commit final	8 months ago
cadastrar_tarefa.feature	commit final	8 months ago
cadastrar_usuario.feature	revisão	8 months ago
clonar_tarefa.feature	commit final	8 months ago
criar_token_api.feature	commit final	8 months ago
desabilitar_usuario.feature	commit final	8 months ago
desmarcar_tarefa_pegajosa.feature	commit final	8 months ago
editar_campo_personalizado.feature	commit final	8 months ago
editar_categoria.feature	commit final	8 months ago
editar_filtro_tarefa.feature	commit final	8 months ago
editar_marcador.feature	commit final	8 months ago
editar_minha_conta.feature	commit final	8 months ago
editar_perfil.feature	commit final	8 months ago
editar_projeto.feature	commit final	8 months ago
enviar_lembrete_tarefa.feature	commit final	8 months ago
excluir_campo_personalizado.feature	revisão	8 months ago
excluir_categoria.feature	commit final	8 months ago
excluir_filtro_tarefa.feature	commit final	8 months ago
excluir_marcador.feature	commit final	8 months ago
excluir_perfil.feature	commit final	8 months ago
excluir_projeto.feature	commit final	8 months ago
excluir_tarefa.feature	commit final	8 months ago
excluir_usuario.feature	revisão	8 months ago
excluir_usuario_projeto.feature	commit final	8 months ago
fechar_tarefa.feature	commit final	8 months ago
imprimir_tarefas.feature	cadastrar e imprimir tarefas	9 months ago
logar_senha_incorreta.feature	commit final	8 months ago
marcar_tarefa_pegajosa.feature	commit final	8 months ago
monitorar_tarefa.feature	commit final	8 months ago
mover_tarefa.feature	commit final	8 months ago
parar_monitoarar_tarefa.feature	commit final	8 months ago
pesquisar_tarefa.feature	revisão	8 months ago
pesquisar_usuario.feature	22 scripts	9 months ago
realizar_login.feature	first commit	10 months ago
realizar_logout.feature	first commit	10 months ago
recuperar_senha.feature	commit final	8 months ago
redefinir_senha.feature	commit final	8 months ago
remover_vinculo_campo_personalizado_projeto.feature	revisão	8 months ago
representar_usuario.feature	commit final	8 months ago
revogar_token_api.feature	51 scripts \o/	8 months ago
salvar_filtro_visualizacao_tarefas.feature	commit final	8 months ago
vincular_campo_personalizado_pro